33333333333333333
30000000000000003
30000000000000003
30000000000000003
30000000000000003
30000000000000003
30000000000000003
30000002000000003
30000002000000003
30000020000000003
30000000000000003
30000000300000003
30000000000000003
30000300003000003
30000030030000003
30000000300000003
33333333333333333