33333333333333333
30222200000092203
32220239222200203
32200299330020023
32222309222090303
30003029090202203
30000200020090003
30023032093000203
30230292002090003
32022920099390203
32000220030322003
32292020320290003
30202203922292003
30002393903030003
30002030930020223
30002000302000203
33333333333333333