0011111111111100000000000001
0000011110000000000000000001
1000011110000000000000000001
1000011110000000000000000001
1000011110000000000000000001
1000000000000000000000000001
1000000000000000000000000001
1000000000000000000000000001
1000000000000000000000000001
1111111111111100000000000001