11111111111111111
10000000000000001
10000000000000001
10000000000000001
10000000000000001
10000000000000001
10000000000000001
10000001000000001
10000001000000001
10000010000000001
10000000000000001
10000000200000001
10000000000000001
10000200002000001
10000020020000001
10000000200000001
11111111111111111