33333333333333333
30222200000002203
32220232222200203
32200230330020023
32222302222000303
30003020030202203
30000200020000003
30023032003000203
30230202002000003
32022020030300203
32000220030322003
32222020320200003
30202203022202003
30002303003030003
30002030030020223
30002000302000203
33333333333333333