33333333333333333
30000200000002003
30220200000000203
32200200330020023
32222300000000003
30003000000200203
30000000000000003
30003002003000203
30000002000000003
30000020000300003
30000000000000003
30020000300000003
30000200022200003
30000300003000003
30000030030000223
30000000300000203
33333333333333333